w w w w w w w w w w w w w w w w w w w w w w w w w w w w w w w w w w w w w w w w w w w w w w w w w w w w w w w w w w w w w w w w w w w w w w w w w w w w w w w w w w w w w w w w w w w w w w w w w w w s 
w w w w w w w w w w w w w w w w w w w w w w w w w w w w w w w w w w w w w w w w w w w w w w w w w w w w w w w w w w w w w w w w w w w w w w w w w w w w w w w w w w w w w w w w w w w w w w w w w w w 4 
w w w w w w w w w w w w w w w w w w w w w w w w w w w w w w w w w w w w w w w w w w w w w w w w w w w w w w w w w w w w w w w w w w w w w w w w w w w w w w w w w w w w w w w w w w w w w w w w w w w 3 
w w w w w w w w w w w w w w w w w w w w w w w w w w w w w w w w w w w w w w w w w w w w w w w w w w w w w w w w w w w w w w w w w w w w w w w w w w w w w w w w w w w w w w w w w w w w w w w w w w w w 
w w w w w w w w w w w w w w w w w w w w w w w w w w w w w w w w w w w w w w w w w w w w w w w w w w w w w w w w w w w w w w w w w w w w w w w w w w w w w w w w w w w w w w w w w w w w w w w w w w w s 
w w w w w w w w w w w w w w w w w w w w w w w w w w w w w w w w s s s s s s s s s s s s s s s s s s s s s s s s s s s s s s w w w w w w w s w w w w w w w w w w w s w w w w w w w w w w w s w w w w w w
w w w w w w w w w w w w w w w w w w w w w w w w w w w w w w w w s s s s s s s s s s s s s s s s s s s s s s s s s s s s s s w w w w w w w s w w w w w w w w w w w s w w w w w w w w w w w s w w w w w w
w w w w w w w w w w w w w w w w w w w w w w w w w w w w w w w w s s 2 1 1 1 1 1 1 1 1 1 1 1 1 1 1 1 1 1 1 1 1 1 1 1 1 3 s s w w w w w w w w w w w w w w w w w w w w w w w w w w w w w w w w w w w w w w
w w w w w w w w w w w w w w w w w w w w w w w w w w w w w w w w s s 0 g g g g g g g g g g g g g g g g g g g g g g g g 0 s s w w w w w w w w w w w w w w w w w w w w w w w w w w w w w w w w w w w w w w
w w w w w w w w w w w w w w w w w w w w w w w w w w w w w w w w s s 0 g g g g g g g g g g g g g g g g g g g g g g g g 0 s s w w w w w w w w w w w w w w w w w w w w w w w w w w w w w w w w w w w w w w
w w w w w w w w w w w w w w w w w w w w w w w w w w w w w w w w s s 0 g g g g g g g g m m m m m m m m g g g g g g g g 0 s s w w w w w w w w w w w w w w w w w w w w w w w w w w w w w w w w w w w w w w
w w w w w w w w w w w w w w w w w w w w w w w w w w w w w w w w s s 0 g g g g g g m m m m m m m m m m m g g g g g g g 0 s s w w w w w w w w w w w w w w w w w w w w w w w w w w w w w w w w w w w w w w
w w w w w w w w w w w w w w w w w w w w w w w w w w w w w w w w s s 0 g g g g m m m m m m m m m m m m m m g g g g g g 0 s s w w w w w w w w w w w w w w w w w w w w w w w w w w w w w w w w w w w w w w
w w w w w w w w w w w w w w w w w w w w w w w w w w w w w w w w s s 0 g g g g m m m m m m m m m m m m m m m g g g g g 0 s s w w w w w w w w w w w w w w w w w w w w w w w w w w w w w w w w w w w w w w
w w w w w w w w w w w w w w w w w w w w w w w w w w w w w w w w s s 0 g g g m m m m n m m m m m m m m n m m m m g g g 0 s s w w w w w w w w w w w w w w w w w w w w w w w w w w w w w w w w w w w w w w
w w w w w w w w w w w w w w w w w w w w w w w w w w w w w w w w s s 0 g g m m m m d n n m m m m m m n a n m m m m g g 0 s s w w w w w w w w w w w w w w w w w w w w w w w w w w w w w w w w w w w w w w
w w w w w w w w w w w w w w w w w w w w w w w w w w w w w w w w s s 0 g g m m m m n n a n m m m m m m n m m m m m g g 0 s s w w w w w w w w w w w w w w w w w w w w w w w w w w w w w w w w w w w w w w
w w w w w w w w w w w w w w w w w w w w w w w w w w w w w w w w s s 0 g g m m m m n d n n m m m m m m m m m m m g g g 0 s s w w w w w w w w w w w w w w w w w w w w w w w w w w w w w w w w w w w w w w
w w w w w w w w w w w w w w w w w w w w w w w w w w w w w w w w s s 0 g g m m m m m n n m m m m m m m m m m m m g g g 0 s s w w w w w w w w w w w w w w w w w w w w w w w w w w w w w w w w w w w w w w
w w w w w w w w w w w w w w w w w w w w w w w w w w w w w w w w s s 0 g g g m m m m m m m m m m m m m m m m m m g g g 0 s s w w w w w w w w w w w w w w w w w w w w w w w w w w w w w w w w w w w w w w
w w w w w w w w w w w w w w w w w w w w w w w w w w w w w w w w s s 0 g g g m m m m m m m m m m m m m m m m m m g g g 0 s s w w w w w w w w w w w w w w w w w w w w w w w w w w w w w w w w w w w w w w
w w w w w w w w w w w w w w w w w w w w w w w w w w w w w w w w s s 0 g g g m m m m m m m m m m m m m m m m m m g g g 0 s s w w w w w w w w w w w w w w w w w w w w w w w w w w w w w w w w w w w w w w
w w w w w w w w w w w w w w w w w w w w w w w w w w w w w w w w s s 0 g g g m m m m m m m m m m m m m m m m m m g g g 0 s s w w w w w w w w w w w w w w w w w w w w w w w w w w w w w w w w w w w w w w
w w w w w w w w w w w w w w w w w w w w w w w w w w w w w w w w s s 0 g g m m m m m m m m m m m m m m m m m m m m g g 0 s s w w w w w w w w w w w w w w w w w w w w w w w w w w w w w w w w w w w w w w
w w w w w w w w w w w w w w w w w w w w w w w w w w w w w w w w s s 0 g g m m m n n m m m m m m m m m m m m m m m g g 0 s s w w w w w w w w w w w w w w w w w w w w w w w w w w w w w w w w w w w w w w
w w w w w w w w w w w w w w w w w w w w w w w w w w w w w w w w s s 0 g g m m n a n n m m m m m n n m m m m m m m g g 0 s s w w w w w w w w w w w w w w w w w w w w w w w w w w w w w w w w w w w w w w
w w w w w w w w w w w w w w w w w w w w w w w w w w w w w w w w s s 0 g g g m n n d n m m m m n n n n m m m m m g g g 0 s s w w w w w w w w w w w w w w w w w w w w w w w w w w w w w w w w w w w w w w
w w w w w w w w w w w w w w w w w w w w w w w w w w w w w w w w s s 0 g g g m m n n m m m m m n a n n m m m m m g g g 0 s s w w w w w w w w w w w w w w w w w w w w w w w w w w w w w w w w w w w w w w
w w w w w w w w w w w w w w w w w w w w w w w w w w w w w w w w s s 0 g g m m m m m m m m m m n n n n n m m m m m g g 0 s s w w w w w w w w w w w w w w w w w w w w w w w w w w w w w w w w w w w w w w
w w w w w w w w w w w w w w w w w w w w w w w w w w w w w w w w s s 0 g g g m m m m m m m m m m n d n n m m m m m g g 0 s s w w w w w w w w w w w w w w w w w w w w w w w w w w w w w w w w w w w w w w
w w w w w w w w w w w w w w w w w w w w w w w w w w w w w w w w s s 0 g g g m m m m m m m m m m n n m m m m m m g g g 0 s s w w w w w w w w w w w w w w w w w w w w w w w w w w w w w w w w w w w w w w
w w w w w w w w w w w w w w w w w w w w w w w w w w w w w w w w s s 0 g g g g m m m m m m m m m m m m m m m m g g g g 0 s s w w w w w w w w w w w w w w w w w w w w w w w w w w w w w w w w w w w w w w
w w w w w w w w w w w w w w w w w w w w w w w w w w w w w w w w s s 0 g g g g m m m m m m m m m m m m m m m m g g g g 0 s s w w w w w w w w w w w w w w w w w w w w w w w w w w w w w w w w w w w w w w
w w w w w w w w w w w w w w w w w w w w w w w w w w w w w w w w s s 0 g g g g g m m m m m m m m m m m m m m g g g g g 0 s s w w w w w w w w w w w w w w w w w w w w w w w w w w w w w w w w w w w w w w
w w w w w w w w w w w w w w w w w w w w w w w w w w w w w w w w s s 0 g g g g g g g g g g m m m g g g g g g g g g g g 0 s s w w w w w w w w w w w w w w w w w w w w w w w w w w w w w w w w w w w w w w
w w w w w w w w w w w w w w w w w w w w w w w w w w w w w w w w s s 0 g g g g g g g g g g m m m g g g g g g g g g g g 0 s s w w w w w w w w w w w w w w w w w w w w w w w w w w w w w w w w w w w w w w
w w w w w w w w w w w w w w w w w w w w w w w w w w w w w w w w s s 4 1 1 1 1 1 1 1 1 1 3 m m m 2 1 1 1 1 1 1 1 1 1 1 5 s s w w w w w w w w w w w w w w w w w w w w w w w w w w w w w w w w w w w w w w
w w w w w w w w w w w w w w w w w w w w w w w w w w w w w w w w s s s s s s s s s s s g 0 _ _ _ 0 g s s s s s s s s s s s s w w w w w w w w w w w w w w w w w w w w w w w w w w w w w w w w w w w w w w
w w w w w w w w w w w w w w w w w w w w w w w w w w w w w w w w s s s s s s s s s s s g 0 _ _ _ 0 g s s s s s s s s s s s s w w w w w w w w w w w w w w w w w w w w w w w w w w w w w w w w w w w w w w
w w w w w w w w w w w w w w w w w w w w w w w w w w w w w w w w w w w w w w w w w w s g 0 _ _ _ 0 g s w w w w w w w w w w w w w w w w w w w w w w w w w w w w w w w w w w w w w w w w w w w w w w w w w
w w w w w w w w w w w w w w w w w w w w w w w w w w w w w w w w w w w w w w w w w w s g 0 _ _ _ 0 g s w w w w w w w w w w w w w w w w w w w w w w w w w w w w w w w w w w w w w w w w w w w w w w w w w
w w w w w w w w w w w w w w w w w w w w w w w w w w w w w w w w w w w w w w w w w w s g 0 _ _ _ 0 g s w w w w w w w w w w w w w w w w w w w w w w w w w w w w w w w w w w w w w w w w w w w w w w w w w
w w w w w w w w w w w w w w w w w w w w w w w w w w w w w w w w w w w w w w w w w w s g 0 _ _ _ 0 g s w w w w w w w w w w w w w w w w w w w w w w w w w w w w w w w w w w w w w w w w w w w w w w w w w
w w w w w w w w w w w w w w w w w w w w w w w w w w w w w w w w w w w w w w w w w w s g 0 _ _ _ 0 g s w w w w w w w w w w w w w w w w w w w w w w w w w w w w w w w w w w w w w w w w w w w w w w w w w
w w w w w w w w w w w w w w w w w w w w w w w w w w w w w w w w w w w w w w w w w w s g 0 _ _ _ 0 g s w w w w w w w w w w w w w w w w w w w w w w w w w w w w w w w w w w w w w w w w w w w w w w w w w
w w w w w w w w w w w w w w w w w w w w w w w w w w w w w w w w w w w w w w w w w w s g 0 _ _ _ 0 g s w w w w w w w w w w w w w w w w w w w w w w w w w w w w w w w w w w w w w w w w w w w w w w w w w
w w w w w s s s s s s s s s s s s s s s s s s s s s s s s s s s s s s s s s s s s s s g 0 _ _ _ 0 g s s s s s s s s s s s s s s s s s s s s s s s s s s s s s s s s s s s s s s s s s s s s s w w w w w
w w w w w s s s s s g g g g g g g g g g g g g g g g g g g g g g g g g g g g g g g g g g 0 _ _ _ 0 g g g g g g g g g g g g g g g g g g g g g g g g g g g g g g g g g g g g g g g g g s s s s s w w w w w
w w w w w s s s s s g g g g g g g g g g g g g g g g g g g g g g g g g g g g g g g g g g 0 _ _ _ 0 g g g g g g g g g g g g g g g g g g g g g g g g g g g g g g g g g g g g g g g g g s s s s s w w w w w
w w w w w s s s s s g g g g g g g g g g g g g g g g g g g g g g g g g g g g g g g g g g 0 _ _ _ 0 g g g g g g g g g g g g g g g g g g g g g g g g g g g g g g g g g g g g g g g g g s s s s s w w w w w
w w w w w s s s s s g g g g g g g g g g g g g g g g g g g g g g g g g g g g g g g g g g 0 _ _ _ 0 g g g g g g g g g g g g g g g g g g g g g g g g g g g g g g g g g g g g g g g g g s s s s s w w w w w
w w w w w s s s s s g g g g 2 1 1 1 1 1 1 1 1 1 1 1 1 1 1 1 1 1 1 1 1 1 1 1 1 1 1 1 1 1 5 _ _ _ 4 1 1 1 1 1 1 1 1 1 1 1 1 1 1 1 1 1 1 1 1 1 1 1 1 1 1 1 1 1 1 1 1 1 1 1 3 g g g g g s s s s s w w w w w
w w w w w s s s s s g g g g 0 g g g g g g g g g g g g g g g g g g g g g g g g g g g g g g _ _ _ g g g g g g g g g g g g g g g g g g g g g g g g g g g g g g g g g g g g 0 g g g g g s s s s s w w w w w
w w w w w s s s s s g g g g 0 g g g g g g g g g g g g g g g g g g g g g g g g g g g g g g _ _ _ g g g g g g g g g g g g g g g g g g g g g g g g g g g g g g g g g g g g 0 g g g g g s s s s s w w w w w
w w w w w s s s s s g g g g 0 g g g g g g g g g g g g g g g g g g g g g g g g g g g g g g _ _ _ g g g g g g g g g g g g g g g g g g g g g g g g g g g g g g g g g g g g 0 g g g g g s s s s s w w w w w
w w w w w s s s s s g g g g 0 g g g g g g g g g g g g g g g g g g g g g g g g g g g g g g _ _ _ g g g g g g g g g g g g g g g g g g g g g g g g g g g g g g g g g g g g 0 g g g g g s s s s s w w w w w
w w w w w s s s s s g g g g 0 g g g g g g g g g g g g g g g g g g g g g g g g g g g g g g _ _ _ g g g g g g g g g g g g g g g g g g g g g g g g g g g g g g g g g g g g 0 g g g g g s s s s s w w w w w
w w w w w s s s s s g g g g 0 g g g g g g g g g g g g g g g g g g g g g g g g g g g g g g _ _ _ g g g g g g g g g g g g g g g g g g g g g g g g g g g g g g g g g g g g 0 g g g g g s s s s s w w w w w
w w w w w s s s s s g g g g 0 g g g g g 8 7 7 7 7 7 7 7 7 9 g g g g g g g g g g g g g g g _ _ _ g g g g g g g g g g g g g g g g g g g g g g g g g g g g g g g g g g g g 0 g g g g g s s s s s w w w w w
w w w w w s s s s s g g g g 0 g g g g g 6 [ f f f f f f [ 6 g g g g g g g g g g g g g g g _ _ _ _ _ _ _ _ _ _ _ _ _ _ _ _ g g g g g g g g g g g g g g g g g g g g g g g 0 g g g g g s s s s s w w w w w
w w w w w s s s s s g g g g 0 g g g g g 6 ] f f f f f f ] 6 g g g g g g g g g g g g g g g _ _ _ _ _ _ _ _ _ _ _ _ _ _ _ _ g g g g g g g g g g g g g g g g g g g g g g g 0 g g g g g s s s s s w w w w w
w w w w w s s s s s g g g g 0 g g g g g 6 f f f f f f f f 6 g g g g g g g g g g g g g g g _ _ _ g g g g g g g g g g g g g g g g g g g g g g g g g g g g g g g g g g g g 0 g g g g g s s s s s w w w w w
w w w w w s s s s s g g g g 0 g g g g g 6 f f f f f f f f 6 g g g g g g g g g g g g g g g _ _ _ g g g g g g g g g g g g g g g g g g g g g g g g g g g g g g g g g g g g 0 g g g g g s s s s s w w w w w
w w w w w s s s s s g g g g 0 g g g g g + 7 7 7 | | 7 7 7 - g g g g g g g g g g g g g g g _ _ _ g g g g g g g g g g g g g g g g g g g g g g g g g g g g g g g g g g g g 0 g g g g g s s s s s w w w w w
w w w w w s s s s s g g g g 0 g g g g g g g g g _ _ g g g g g g g g g g g g g g g g g g g _ _ _ g g g g g g g g g g g g g g g g g g g g g g g g g g g g g g g g g g g g 0 g g g g g s s s s s w w w w w
w w w w w s s s s s g g g g 0 g g g g g g g g g _ _ g g g g g g g g g g g g g g g g g g g _ _ _ g g g g g g g g g g g g g g g g g g g g g g g g g g g g g g g g g g g g 0 g g g g g s s s s s w w w w w
w w w w w s s s s s g g g g 0 g g g g g g g g g _ _ g g g g g g g g g g g g g g g g g g g _ _ _ g g g g g g g g g g g g g g g g g g g g g g g g g g g g g g g g g g g g 0 g g g g g s s s s s w w w w w
w w w w w s s s s s g g g g 0 g g g g g g g g g _ _ g g g g g g g g g g g g g g g g g g g _ _ _ g g 8 7 7 7 7 7 7 7 7 7 7 7 7 7 7 7 7 7 7 7 7 7 7 7 7 7 7 7 7 7 9 g g g 0 g g g g g s s s s s w w w w w
w w w w w s s s s s g g g g 0 g g g g g g g g g _ _ g g g g g g g g g g g g g g g g g g g _ _ _ g g 6 [ f f f 6 [ f f f 6 [ f f f 6 [ f f f 6 [ f f f 6 [ f f f 6 g g g 0 g g g g g s s s s s w w w w w
w w w w w s s s s s g g g g 0 g g g g g g g g g _ _ g g g g g g g g g g g g g g g g g g g _ _ _ g g 6 ] f f f 6 ] f f f 6 ] f f f 6 ] f f f 6 ] f f f 6 ] f f f 6 g g g 0 g g g g g s s s s s w w w w w
w w w w w s s s s s g g g g 0 g g g g g g g g g _ _ g g g g g g g g g g g g g g g g g g g _ _ _ g g 6 f f f f 6 f f f f 6 f f f f 6 f f f f 6 f f f f 6 f f f f 6 g g g 0 g g g g g s s s s s w w w w w
w w w w w s s s s s g g g g 0 g g g g g g g g g _ _ g g g g g g g g g g g g g g g g g g g _ _ _ g g 6 7 7 7 | 7 7 | 7 7 7 7 7 | 7 7 7 | 7 7 7 7 7 | 7 7 7 | 7 7 7 g g g 0 g g g g g s s s s s w w w w w
w w w w w s s s s s g g g g 0 g g g g g g g g g _ _ g g g g g g g g g g g g g g g g g g g _ _ _ g g 6 f f f f f f f f f f f f f f f f f f f f f f f f f f f f f 6 g g g 0 g g g g g s s s s s w w w w w
w w w w w s s s s s g g g g 0 g g g g g g g g g _ _ _ _ _ _ _ _ _ _ _ _ _ _ _ _ _ _ _ _ _ _ _ _ _ _ = f f f f f f f f f f f f f f f f f f f f f f f f f f f f f 6 g g g 0 g g g g g s s s s s w w w w w
w w w w w s s s s s g g g g 0 g g g g g g g g g _ _ _ _ _ _ _ _ _ _ _ _ _ _ _ _ _ _ _ _ _ _ _ _ _ _ = f f f f f f f f f f f f f f f f f f f f f f f f f f f f f 6 g g g 0 g g g g g s s s s s w w w w w
w w w w w s s s s s g g g g 0 g g g g g g g g g g g g g g g g g g g g g g g g g g g g g g g g g g g 6 f f f f f f f f f f f f f f f f f f f f f f f f f f f f f 6 g g g 0 g g g g g s s s s s w w w w w
w w w w w s s s s s g g g g 0 g g g g g g g g g g g g g g g g g g g g g g g g g g g g g g g g g g g 6 7 7 7 | 7 7 | 7 7 7 7 7 | 7 7 7 | 7 7 7 7 7 | 7 7 7 | 7 7 7 g g g 0 g g g g g s s s s s w w w w w
w w w w w s s s s s g g g g 0 g g g g g g g g g g g g g g g g g g g g g g g g g g g g g g g g g g g 6 f f f f 6 f f f f 6 f f f f 6 f f f f 6 f f f f 6 f f f f 6 g g g 0 g g g g g s s s s s w w w w w
w w w w w s s s s s g g g g 0 g g g g g g g g g g g g g g g g g g g g g g g g g g g g g g g g g g g 6 [ f f f 6 [ f f f 6 [ f f f 6 [ f f f 6 [ f f f 6 [ f f f 6 g g g 0 g g g g g s s s s s w w w w w
w w w w w s s s s s g g g g 0 g g g g g g g g g g g g g g g g g g g g g g g g g g g g g g g g g g g 6 ] f f f 6 ] f f f 6 ] f f f 6 ] f f f 6 ] f f f 6 ] f f f 6 g g g 0 g g g g g s s s s s w w w w w
w w w w w s s s s s g g g g 0 g g g g g g g g g g g g g g g g g g g g g g g g g g g g g g g g g g g + 7 7 7 7 7 7 7 7 7 7 7 7 7 7 7 7 7 7 7 7 7 7 7 7 7 7 7 7 7 - g g g 0 g g g g g s s s s s w w w w w
w w w w w s s s s s g g g g 0 g g g g g g g g g g g g g g g g g g g g g g g g g g g g g g g g g g g g g g g g g g g g g g g g g g g g g g g g g g g g g g g g g g g g g 0 g g g g g s s s s s w w w w w
w w w w w s s s s s g g g g 0 g g g g g g g g g g g g g g g g g g g g g g g g g g g g g g g g g g g g g g g g g g g g g g g g g g g g g g g g g g g g g g g g g g g g g 0 g g g g g s s s s s w w w w w
w w w w w s s s s s g g g g 0 g g g g g g g g g g g g g g g g g g g g g g g g g g g g g g g g g g g g g g g g g g g g g g g g g g g g g g g g g g g g g g g g g g g g g 0 g g g g g s s s s s w w w w w
w w w w w s s s s s g g g g 4 1 1 1 1 1 1 1 1 1 1 1 1 1 1 1 1 1 1 1 1 1 1 1 1 1 1 1 1 1 1 1 1 1 1 1 1 1 1 1 1 1 1 1 1 1 1 1 1 1 1 1 1 1 1 1 1 1 1 1 1 1 1 1 1 1 1 1 1 1 5 g g g g g s s s s s w w w w w
w w w w w s s s s s g g g g g g g g g g g g g g g g g g g g g g g g g g g g g g g g g g g g g g g g g g g g g g g g g g g g g g g g g g g g g g g g g g g g g g g g g g g g g g g g s s s s s w w w w w
w w w w w s s s s s g g g g g g g g g g g g g g g g g g g g g g g g g g g g g g g g g g g g g g g g g g g g g g g g g g g g g g g g g g g g g g g g g g g g g g g g g g g g g g g g s s s s s w w w w w
w w w w w s s s s s g g g g g g g g g g g g g g g g g g g g g g g g g g g g g g g g g g g g g g g g g g g g g g g g g g g g g g g g g g g g g g g g g g g g g g g g g g g g g g g g s s s s s w w w w w
w w w w w s s s s s g g g g g g g g g g g g g g g g g g g g g g g g g g g g g g g g g g g g g g g g g g g g g g g g g g g g g g g g g g g g g g g g g g g g g g g g g g g g g g g g s s s s s w w w w w
w w w w w s s s s s s s s s s s s s s s s s s s s s s s s s s s s s s s s s s s s s s s s s s s s s s s s s s s s s s s s s s s s s s s s s s s s s s s s s s s s s s s s s s s s s s s s s s w w w w w
w w w w w s s s s s s s s s s s s s s s s s s s s s s s s s s s s s s s s s s s s s s s s s s s s s s s s s s s s s s s s s s s s s s s s s s s s s s s s s s s s s s s s s s s s s s s s s s w w w w w
w w w w w s s s s s s s s s s s s s s s s s s s s s s s s s s s s s s s s s s s s s s s s s s s s s s s s s s s s s s s s s s s s s s s s s s s s s s s s s s s s s s s s s s s s s s s s s s w w w w w
w w w w w s s s s s s s s s s s s s s s s s s s s s s s s s s s s s s s s s s s s s s s s s s s s s s s s s s s s s s s s s s s s s s s s s s s s s s s s s s s s s s s s s s s s s s s s s s w w w w w
w w w w w s s s s s s s s s s s s s s s s s s s s s s s s s s s s s s s s s s s s s s s s s s s s s s s s s s s s s s s s s s s s s s s s s s s s s s s s s s s s s s s s s s s s s s s s s s w w w w w
w w w w w w w w w w w w w w w w w w w w w w w w w w w w w w w w w w w w w w w w w w w w w w w w w w w w w w w w w w w w w w w w w w w w w w w w w w w w w w w w w w w w w w w w w w w w w w w w w w w w 
w w w w w w w w w w w w w w w w w w w w w w w w w w w w w w w w w w w w w w w w w w w w w w w w w w w w w w w w w w w w w w w w w w w w w w w w w w w w w w w w w w w w w w w w w w w w w w w w w w w w 
w w w w w w w w w w w w w w w w w w w w w w w w w w w w w w w w w w w w w w w w w w w w w w w w w w w w w w w w w w w w w w w w w w w w w w w w w w w w w w w w w w w w w w w w w w w w w w w w w w w w 
w w w w w w w w w w w w w w w w w w w w w w w w w w w w w w w w w w w w w w w w w w w w w w w w w w w w w w w w w w w w w w w w w w w w w w w w w w w w w w w w w w w w w w w w w w w w w w w w w w w w 
w w w w w w w w w w w w w w w w w w w w w w w w w w w w w w w w w w w w w w w w w w w w w w w w w w w w w w w w w w w w w w w w w w w w w w w w w w w w w w w w w w w w w w w w w w w w w w w w w w w w 
w w w w w w w w w w w w w w w w w w w w w w w w w w w w w w w w w w w w w w w w w w w w w w w w w w w w w w w w w w w w w w w w w w w w w w w w w w w w w w w w w w w w w w w w w w w w w w w w w w w w 